ПО - Tarkvara -TA
Процесс разработки ПО - Tarkvara arendusprotsess
Документация на ПО - Tarkvara dokumentatsioon
Проект - Projekt 
ИТ проект - IT projekt  
Бизнес-проект - Äriprojekt
Проект по разработке - Arendusprojekt
Проект по реализации - realiseerimis Projekt / teostusprojekt
Диаграмма Ганта - Gantii diagramm 

***Lisa esimese faili juurde järgmised tõlked:

?критический путь проекта - Kriitiline tee projekti
?виды рисков в проекте - Riskide liigid projektis
?аутсортсинг - Allhanked
?краудсортсинг - Crowdsourcing
?ИТ аудит - IT audit
?ERP системы - ERP süsteemi
?ROI для оценки проектов - ROI projektide hindamiseks
?Tacit - Tacit
?Knowledge Managment System - Teadmiste haldamise süsteem
?cистемы управления базами данных – какие знаете - MySQL, MSS(MicrosoftSQLServer), Oracle
?Project Managment Tool - Projektide haldamise tööriist

Mudel - Модель
kasutusmalliskeem - kasutuslooskeem - прецедентов диаграмма  
tegevusskeem - диаграмма активности / деятельности 

jadaskeem - диаграмма последовательности
klassiskeem - диаграмма классов
koostööskeem - диаграмма взаимодействия

andmebaasiskeem - диаграмма баз данных
olem - сущность
seos - связь

muster - узор / схема / шаблон 
mustand - черновик

punkt - точка
romb - ромб
ristkülik - прямоугольник
joon - линия 
nool - стрелка
algussõlm - начальная узел
ovaal - овал

